,county,occupied_units,vacant_units,year,percent_occupied,total_units
0,"Adams County, Ohio",10835,2085,2018,0.8386222910216719,12920
1,"Allen County, Ohio",40537,4526,2018,0.8995628342542662,45063
2,"Ashland County, Ohio",20439,1811,2018,0.9186067415730337,22250
3,"Ashtabula County, Ohio",37652,8455,2018,0.8166222048712777,46107
4,"Athens County, Ohio",22620,3990,2018,0.8500563697857948,26610
5,"Auglaize County, Ohio",18723,1129,2018,0.9431291557525691,19852
6,"Belmont County, Ohio",26200,6011,2018,0.8133867312408805,32211
7,"Brown County, Ohio",17434,2614,2018,0.8696129289704708,20048
8,"Butler County, Ohio",138226,12972,2018,0.9142052143546873,151198
9,"Carroll County, Ohio",11126,2520,2018,0.8153304997801554,13646
10,"Champaign County, Ohio",15209,1584,2018,0.9056749836241291,16793
11,"Clark County, Ohio",54905,6405,2018,0.895530908497798,61310
12,"Clermont County, Ohio",77181,5649,2018,0.9318000724375226,82830
13,"Clinton County, Ohio",16370,1808,2018,0.9005391132137749,18178
14,"Columbiana County, Ohio",41854,4964,2018,0.8939724037763254,46818
15,"Coshocton County, Ohio",14461,1994,2018,0.8788210270434519,16455
16,"Crawford County, Ohio",17755,2298,2018,0.8854036802473445,20053
17,"Cuyahoga County, Ohio",538531,80261,2018,0.8702940568074571,618792
18,"Darke County, Ohio",20838,2006,2018,0.9121870075293294,22844
19,"Defiance County, Ohio",15213,1594,2018,0.9051585648836794,16807
20,"Delaware County, Ohio",68649,3310,2018,0.9540015842354674,71959
21,"Erie County, Ohio",31301,6558,2018,0.8267783089886157,37859
22,"Fairfield County, Ohio",55748,4825,2018,0.9203440476780084,60573
23,"Fayette County, Ohio",11736,1024,2018,0.9197492163009404,12760
24,"Franklin County, Ohio",504702,45957,2018,0.9165418162601537,550659
25,"Fulton County, Ohio",16425,1095,2018,0.9375,17520
26,"Gallia County, Ohio",11662,2230,2018,0.8394759573855456,13892
27,"Geauga County, Ohio",35285,1790,2018,0.9517194875252866,37075
28,"Greene County, Ohio",65406,4472,2018,0.9360027476458971,69878
29,"Guernsey County, Ohio",16098,3187,2018,0.8347420274824994,19285
30,"Hamilton County, Ohio",339966,38871,2018,0.8973938659634618,378837
31,"Hancock County, Ohio",31887,2143,2018,0.937026153394064,34030
32,"Hardin County, Ohio",11495,1692,2018,0.8716918176992493,13187
33,"Harrison County, Ohio",6200,1911,2018,0.7643940327949698,8111
34,"Henry County, Ohio",11065,1006,2018,0.9166597630685113,12071
35,"Highland County, Ohio",16646,2680,2018,0.8613267101314291,19326
36,"Hocking County, Ohio",11120,2276,2018,0.8300985368766796,13396
37,"Holmes County, Ohio",12437,1203,2018,0.9118035190615835,13640
38,"Huron County, Ohio",22860,2387,2018,0.9054541133600031,25247
39,"Jackson County, Ohio",12892,1882,2018,0.8726140517124679,14774
40,"Jefferson County, Ohio",27363,5165,2018,0.8412137235612396,32528
41,"Knox County, Ohio",23340,2391,2018,0.9070770665733939,25731
42,"Lake County, Ohio",95980,6639,2018,0.935304378331498,102619
43,"Lawrence County, Ohio",23540,3984,2018,0.8552535968609214,27524
44,"Licking County, Ohio",64016,6631,2018,0.9061389726386117,70647
45,"Logan County, Ohio",18654,4745,2018,0.7972135561348775,23399
46,"Lorain County, Ohio",119536,10893,2018,0.9164832974261858,130429
47,"Lucas County, Ohio",179065,24008,2018,0.8817765040157973,203073
48,"Madison County, Ohio",15080,988,2018,0.9385113268608414,16068
49,"Mahoning County, Ohio",98052,13395,2018,0.879808339390024,111447
50,"Marion County, Ohio",24616,3292,2018,0.8820409918302996,27908
51,"Medina County, Ohio",68121,3761,2018,0.9476781391725327,71882
52,"Meigs County, Ohio",9193,1980,2018,0.8227870759867538,11173
53,"Mercer County, Ohio",16104,1831,2018,0.8979091162531363,17935
54,"Miami County, Ohio",41081,3242,2018,0.926855131647226,44323
55,"Monroe County, Ohio",5945,1578,2018,0.7902432540210023,7523
56,"Montgomery County, Ohio",223894,30927,2018,0.8786324517994984,254821
57,"Morgan County, Ohio",6147,1802,2018,0.7733048182161278,7949
58,"Morrow County, Ohio",12650,1621,2018,0.8864130053955575,14271
59,"Muskingum County, Ohio",34239,3707,2018,0.9023085437200232,37946
60,"Noble County, Ohio",4967,1177,2018,0.8084309895833334,6144
61,"Ottawa County, Ohio",17691,10700,2018,0.6231200028177943,28391
62,"Paulding County, Ohio",7770,985,2018,0.8874928612221588,8755
63,"Perry County, Ohio",13547,1758,2018,0.8851355766089514,15305
64,"Pickaway County, Ohio",19728,1634,2018,0.9235090347345755,21362
65,"Pike County, Ohio",10822,1997,2018,0.8442156174428582,12819
66,"Portage County, Ohio",61993,6841,2018,0.9006159746636836,68834
67,"Preble County, Ohio",16090,1796,2018,0.8995862685899586,17886
68,"Putnam County, Ohio",13236,656,2018,0.952778577598618,13892
69,"Richland County, Ohio",47998,6282,2018,0.8842667649226235,54280
70,"Ross County, Ohio",28747,3326,2018,0.8962990677516914,32073
71,"Sandusky County, Ohio",23562,2774,2018,0.894668894289186,26336
72,"Scioto County, Ohio",30086,4339,2018,0.8739578794480756,34425
73,"Seneca County, Ohio",21652,2462,2018,0.897901633905615,24114
74,"Shelby County, Ohio",18643,1778,2018,0.9129327652906322,20421
75,"Stark County, Ohio",152649,13853,2018,0.9167997982006222,166502
76,"Summit County, Ohio",224385,21407,2018,0.9129060343705246,245792
77,"Trumbull County, Ohio",86163,9544,2018,0.9002789764594021,95707
78,"Tuscarawas County, Ohio",36817,3370,2018,0.9161420359817851,40187
79,"Union County, Ohio",19546,1229,2018,0.9408423586040915,20775
80,"Van Wert County, Ohio",11419,1313,2018,0.8968740182218033,12732
81,"Vinton County, Ohio",5111,1159,2018,0.8151515151515152,6270
82,"Warren County, Ohio",81859,4098,2018,0.9523249997091568,85957
83,"Washington County, Ohio",25139,3097,2018,0.8903173254001984,28236
84,"Wayne County, Ohio",43385,3115,2018,0.933010752688172,46500
85,"Williams County, Ohio",15246,1414,2018,0.915126050420168,16660
86,"Wood County, Ohio",50443,3467,2018,0.9356891114820998,53910
87,"Wyandot County, Ohio",9076,869,2018,0.9126194067370538,9945
0,"Wood County, Ohio",50187,3599,2017,0.9330866768304019,53786
1,"Henry County, Ohio",11094,949,2017,0.9211990367848543,12043
2,"Jefferson County, Ohio",27571,5030,2017,0.8457102542866783,32601
3,"Columbiana County, Ohio",41582,5242,2017,0.8880488638305143,46824
4,"Darke County, Ohio",20803,2010,2017,0.911892342085653,22813
5,"Guernsey County, Ohio",16065,3219,2017,0.8330740510267579,19284
6,"Mahoning County, Ohio",98035,13464,2017,0.8792455537717827,111499
7,"Auglaize County, Ohio",18342,1468,2017,0.9258960121150934,19810
8,"Ashland County, Ohio",20504,1731,2017,0.9221497638857656,22235
9,"Ashtabula County, Ohio",38381,7737,2017,0.8322347022854417,46118
10,"Portage County, Ohio",62208,6415,2017,0.9065182227533043,68623
11,"Putnam County, Ohio",13159,698,2017,0.9496283466839864,13857
12,"Ottawa County, Ohio",17495,10805,2017,0.6181978798586573,28300
13,"Fulton County, Ohio",16404,1078,2017,0.938336574762613,17482
14,"Hardin County, Ohio",11430,1754,2017,0.8669599514563107,13184
15,"Belmont County, Ohio",26910,5377,2017,0.8334623842413356,32287
16,"Clinton County, Ohio",16309,1850,2017,0.8981221432898288,18159
17,"Athens County, Ohio",22509,4088,2017,0.8462984547129375,26597
18,"Hocking County, Ohio",11268,2123,2017,0.84146068254798,13391
19,"Lake County, Ohio",95238,7124,2017,0.9304038608077216,102362
20,"Adams County, Ohio",10829,2095,2017,0.837898483441659,12924
21,"Scioto County, Ohio",30204,4128,2017,0.8797623208668298,34332
22,"Medina County, Ohio",67192,4118,2017,0.942252138549993,71310
23,"Wayne County, Ohio",43353,3016,2017,0.934956544242921,46369
24,"Wyandot County, Ohio",9157,777,2017,0.9217837729011475,9934
25,"Jackson County, Ohio",12964,1777,2017,0.8794518689369785,14741
26,"Lucas County, Ohio",178971,23881,2017,0.8822737759548833,202852
27,"Fayette County, Ohio",11729,985,2017,0.922526348906717,12714
28,"Noble County, Ohio",5012,1114,2017,0.8181521384263793,6126
29,"Preble County, Ohio",16126,1773,2017,0.9009441868260797,17899
30,"Logan County, Ohio",18627,4716,2017,0.797969412671893,23343
31,"Mercer County, Ohio",16142,1709,2017,0.9042630664948742,17851
32,"Ross County, Ohio",28526,3511,2017,0.8904079657895558,32037
33,"Clark County, Ohio",54836,6505,2017,0.8939534732071535,61341
34,"Meigs County, Ohio",9285,1870,2017,0.8323621694307486,11155
35,"Union County, Ohio",19038,1385,2017,0.932184302012437,20423
36,"Brown County, Ohio",17333,2584,2017,0.8702615855801576,19917
37,"Butler County, Ohio",136416,14107,2017,0.9062801033729064,150523
38,"Erie County, Ohio",31577,6250,2017,0.8347741031538319,37827
39,"Cuyahoga County, Ohio",537621,81684,2017,0.8681037614745561,619305
40,"Champaign County, Ohio",15274,1500,2017,0.9105758912602838,16774
41,"Pike County, Ohio",11033,1715,2017,0.8654690931910888,12748
42,"Monroe County, Ohio",5984,1520,2017,0.7974413646055437,7504
43,"Montgomery County, Ohio",223495,31345,2017,0.8770012556898447,254840
44,"Paulding County, Ohio",7589,1161,2017,0.8673142857142857,8750
45,"Holmes County, Ohio",12520,1119,2017,0.9179558618667057,13639
46,"Perry County, Ohio",13576,1681,2017,0.8898210657403159,15257
47,"Pickaway County, Ohio",19465,1845,2017,0.9134209291412483,21310
48,"Morrow County, Ohio",12781,1453,2017,0.8979204721090347,14234
49,"Madison County, Ohio",14916,1125,2017,0.929867215260894,16041
50,"Seneca County, Ohio",21507,2598,2017,0.892221530802738,24105
51,"Lawrence County, Ohio",23731,3770,2017,0.8629140758517873,27501
52,"Marion County, Ohio",24699,3195,2017,0.8854592385459239,27894
53,"Hancock County, Ohio",32049,1832,2017,0.9459283964463859,33881
54,"Clermont County, Ohio",76143,6257,2017,0.9240655339805826,82400
55,"Trumbull County, Ohio",86709,9068,2017,0.9053217369514601,95777
56,"Fairfield County, Ohio",55549,4653,2017,0.9227102089631574,60202
57,"Stark County, Ohio",152037,14170,2017,0.9147448663413695,166207
58,"Summit County, Ohio",223021,22710,2017,0.9075818679775852,245731
59,"Muskingum County, Ohio",34348,3599,2017,0.905157192926977,37947
60,"Allen County, Ohio",40319,4686,2017,0.8958782357515832,45005
61,"Coshocton County, Ohio",14367,2083,2017,0.8733738601823708,16450
62,"Sandusky County, Ohio",23721,2611,2017,0.900843080662312,26332
63,"Shelby County, Ohio",18665,1734,2017,0.914995833129075,20399
64,"Crawford County, Ohio",17833,2251,2017,0.8879207329217288,20084
65,"Delaware County, Ohio",67701,3052,2017,0.9568640199002163,70753
66,"Gallia County, Ohio",11520,2372,2017,0.8292542470486611,13892
67,"Morgan County, Ohio",6116,1810,2017,0.7716376482462781,7926
68,"Harrison County, Ohio",6192,1918,2017,0.763501849568434,8110
69,"Knox County, Ohio",23229,2419,2017,0.9056846537741734,25648
70,"Defiance County, Ohio",15309,1466,2017,0.9126080476900149,16775
71,"Highland County, Ohio",16731,2608,2017,0.8651429753348157,19339
72,"Warren County, Ohio",80704,4149,2017,0.9511036734116649,84853
73,"Greene County, Ohio",64702,4874,2017,0.9299471081982292,69576
74,"Hamilton County, Ohio",338267,39889,2017,0.8945170776081829,378156
75,"Licking County, Ohio",64434,6015,2017,0.9146190861474258,70449
76,"Huron County, Ohio",22876,2383,2017,0.9056573894453462,25259
77,"Van Wert County, Ohio",11503,1223,2017,0.9038975326104038,12726
78,"Washington County, Ohio",25378,2873,2017,0.8983044847969983,28251
79,"Geauga County, Ohio",35121,1800,2017,0.9512472576582433,36921
80,"Williams County, Ohio",15263,1367,2017,0.9177991581479255,16630
81,"Lorain County, Ohio",118594,11123,2017,0.9142517942906481,129717
82,"Miami County, Ohio",40900,3393,2017,0.9233964734833947,44293
83,"Franklin County, Ohio",496337,49703,2017,0.9089755329279906,546040
84,"Richland County, Ohio",47987,6287,2017,0.8841618454508604,54274
85,"Vinton County, Ohio",5053,1208,2017,0.80705957514774,6261
86,"Carroll County, Ohio",10917,2702,2017,0.8016007048975696,13619
87,"Tuscarawas County, Ohio",36548,3632,2017,0.9096067695370831,40180
0,"Adams County, Ohio",10885,1897,2016,0.8515881708652793,12782
1,"Allen County, Ohio",40039,4811,2016,0.8927313266443702,44850
2,"Ashland County, Ohio",20391,1713,2016,0.9225027144408252,22104
3,"Ashtabula County, Ohio",38800,7050,2016,0.8462377317339149,45850
4,"Athens County, Ohio",22328,4042,2016,0.8467197572999621,26370
5,"Auglaize County, Ohio",18231,1448,2016,0.9264190253569795,19679
6,"Belmont County, Ohio",27732,4387,2016,0.8634141785236153,32119
7,"Brown County, Ohio",17047,2552,2016,0.8697892749630083,19599
8,"Butler County, Ohio",135100,14318,2016,0.9041748651434232,149418
9,"Carroll County, Ohio",10871,2672,2016,0.8027025031381525,13543
10,"Champaign County, Ohio",15162,1522,2016,0.9087748741309039,16684
11,"Clark County, Ohio",54681,6462,2016,0.8943133310436191,61143
12,"Clermont County, Ohio",75236,6475,2016,0.9207573031782746,81711
13,"Clinton County, Ohio",16077,1983,2016,0.8901993355481728,18060
14,"Columbiana County, Ohio",41782,4809,2016,0.8967826404241163,46591
15,"Coshocton County, Ohio",14397,1961,2016,0.8801198190487834,16358
16,"Crawford County, Ohio",17657,2356,2016,0.8822765202618298,20013
17,"Cuyahoga County, Ohio",534559,84114,2016,0.8640412625086273,618673
18,"Darke County, Ohio",20831,1885,2016,0.9170188413453073,22716
19,"Defiance County, Ohio",15378,1334,2016,0.9201771182383915,16712
20,"Delaware County, Ohio",66544,3013,2016,0.9566830081803414,69557
21,"Erie County, Ohio",31731,5984,2016,0.8413363383269257,37715
22,"Fairfield County, Ohio",55138,4471,2016,0.9249945478031841,59609
23,"Fayette County, Ohio",11666,1005,2016,0.9206850288059348,12671
24,"Franklin County, Ohio",489010,51769,2016,0.9042695814741327,540779
25,"Fulton County, Ohio",16240,1127,2016,0.9351068117694478,17367
26,"Gallia County, Ohio",11495,2232,2016,0.8374007430611204,13727
27,"Geauga County, Ohio",34890,1843,2016,0.9498271309177034,36733
28,"Greene County, Ohio",64279,4860,2016,0.9297068224880314,69139
29,"Guernsey County, Ohio",15863,3247,2016,0.8300889586603872,19110
30,"Hamilton County, Ohio",335334,41934,2016,0.8888482458093451,377268
31,"Hancock County, Ohio",31549,2020,2016,0.9398254341803449,33569
32,"Hardin County, Ohio",11588,1516,2016,0.8843101343101343,13104
33,"Harrison County, Ohio",6242,1823,2016,0.7739615623062617,8065
34,"Henry County, Ohio",11035,952,2016,0.920580629014766,11987
35,"Highland County, Ohio",16635,2532,2016,0.8678979496008765,19167
36,"Hocking County, Ohio",11326,1953,2016,0.8529256721138639,13279
37,"Holmes County, Ohio",12500,1050,2016,0.922509225092251,13550
38,"Huron County, Ohio",22521,2578,2016,0.8972867444918124,25099
39,"Jackson County, Ohio",12814,1751,2016,0.8797802952282869,14565
40,"Jefferson County, Ohio",27776,4682,2016,0.8557520488015281,32458
41,"Knox County, Ohio",23029,2433,2016,0.9044458408608907,25462
42,"Lake County, Ohio",95249,6636,2016,0.9348677430436276,101885
43,"Lawrence County, Ohio",23243,4070,2016,0.8509867096254531,27313
44,"Licking County, Ohio",64034,5893,2016,0.9157264003889771,69927
45,"Logan County, Ohio",18720,4454,2016,0.807801846897385,23174
46,"Lorain County, Ohio",117609,11157,2016,0.9133544569218582,128766
47,"Lucas County, Ohio",178477,23830,2016,0.8822087223872629,202307
48,"Madison County, Ohio",14809,1155,2016,0.9276497118516662,15964
49,"Mahoning County, Ohio",97484,13791,2016,0.8760638058863177,111275
50,"Marion County, Ohio",24418,3365,2016,0.8788827700392327,27783
51,"Medina County, Ohio",66465,4244,2016,0.939979351991967,70709
52,"Meigs County, Ohio",9204,1800,2016,0.836423118865867,11004
53,"Mercer County, Ohio",16109,1603,2016,0.909496386630533,17712
54,"Miami County, Ohio",41106,3072,2016,0.930463126443026,44178
55,"Monroe County, Ohio",5986,1471,2016,0.8027356845916589,7457
56,"Montgomery County, Ohio",222677,31706,2016,0.8753611680025788,254383
57,"Morgan County, Ohio",5932,1902,2016,0.7572121521572632,7834
58,"Morrow County, Ohio",12606,1482,2016,0.8948040885860307,14088
59,"Muskingum County, Ohio",34178,3596,2016,0.9048022449303754,37774
60,"Noble County, Ohio",4863,1171,2016,0.8059330460722572,6034
61,"Ottawa County, Ohio",17384,10628,2016,0.620591175210624,28012
62,"Paulding County, Ohio",7659,1026,2016,0.8818652849740932,8685
63,"Perry County, Ohio",13535,1570,2016,0.8960609069844422,15105
64,"Pickaway County, Ohio",19173,1977,2016,0.9065248226950354,21150
65,"Pike County, Ohio",10908,1625,2016,0.8703422963376686,12533
66,"Portage County, Ohio",61585,6521,2016,0.9042521951076263,68106
67,"Preble County, Ohio",16048,1811,2016,0.8985945461671986,17859
68,"Putnam County, Ohio",13092,682,2016,0.9504864236968201,13774
69,"Richland County, Ohio",47935,6275,2016,0.8842464489946504,54210
70,"Ross County, Ohio",28308,3499,2016,0.8899927688873518,31807
71,"Sandusky County, Ohio",23666,2563,2016,0.9022837317473026,26229
72,"Scioto County, Ohio",29778,4268,2016,0.8746401926804911,34046
73,"Seneca County, Ohio",21349,2622,2016,0.8906178298777689,23971
74,"Shelby County, Ohio",18428,1899,2016,0.9065774585526639,20327
75,"Stark County, Ohio",151101,14423,2016,0.9128645996955125,165524
76,"Summit County, Ohio",221887,23277,2016,0.9050553914930414,245164
77,"Trumbull County, Ohio",86508,8958,2016,0.9061655458487838,95466
78,"Tuscarawas County, Ohio",36325,3622,2016,0.9093298620672391,39947
79,"Union County, Ohio",18798,1232,2016,0.9384922616075886,20030
80,"Van Wert County, Ohio",11427,1235,2016,0.9024640657084189,12662
81,"Vinton County, Ohio",4942,1232,2016,0.800453514739229,6174
82,"Warren County, Ohio",79466,4281,2016,0.9488817509880951,83747
83,"Washington County, Ohio",25306,2777,2016,0.9011145532884663,28083
84,"Wayne County, Ohio",43037,2965,2016,0.9355462805964958,46002
85,"Williams County, Ohio",15077,1445,2016,0.912540854618085,16522
86,"Wood County, Ohio",50025,3381,2016,0.9366925064599483,53406
87,"Wyandot County, Ohio",9144,737,2016,0.9254124076510475,9881
0,"Adams County, Ohio",10858,1990,2015,0.8451120797011208,12848
1,"Allen County, Ohio",39986,4873,2015,0.8913707394279855,44859
2,"Ashland County, Ohio",20427,1677,2015,0.9241313789359392,22104
3,"Ashtabula County, Ohio",38890,7017,2015,0.8471474938462544,45907
4,"Athens County, Ohio",22486,3774,2015,0.8562833206397563,26260
5,"Auglaize County, Ohio",18193,1448,2015,0.9262766661575276,19641
6,"Belmont County, Ohio",27935,4285,2015,0.867008069522036,32220
7,"Brown County, Ohio",16672,2677,2015,0.8616465967233449,19349
8,"Butler County, Ohio",134720,14296,2015,0.9040639931282547,149016
9,"Carroll County, Ohio",10972,2638,2015,0.8061719324026451,13610
10,"Champaign County, Ohio",15237,1477,2015,0.911630968050736,16714
11,"Clark County, Ohio",54809,6432,2015,0.894972322463709,61241
12,"Clermont County, Ohio",74812,6856,2015,0.9160503501983641,81668
13,"Clinton County, Ohio",16073,1990,2015,0.8898300393068704,18063
14,"Columbiana County, Ohio",42087,4690,2015,0.899737050259743,46777
15,"Coshocton County, Ohio",14335,2073,2015,0.8736591906387128,16408
16,"Crawford County, Ohio",17798,2254,2015,0.8875922601236784,20052
17,"Cuyahoga County, Ohio",534719,84584,2015,0.8634206519264399,619303
18,"Darke County, Ohio",20865,1858,2015,0.918232627734014,22723
19,"Defiance County, Ohio",15279,1430,2015,0.9144173798551679,16709
20,"Delaware County, Ohio",65648,3020,2015,0.9560202714510397,68668
21,"Erie County, Ohio",31767,5972,2015,0.8417552134396777,37739
22,"Fairfield County, Ohio",55032,4335,2015,0.9269796351508414,59367
23,"Fayette County, Ohio",11589,1079,2015,0.9148247552889169,12668
24,"Franklin County, Ohio",480946,55865,2015,0.895931715259188,536811
25,"Fulton County, Ohio",16229,1139,2015,0.9344196222938738,17368
26,"Gallia County, Ohio",11590,2230,2015,0.8386396526772794,13820
27,"Geauga County, Ohio",34774,1909,2015,0.9479595452934602,36683
28,"Greene County, Ohio",64182,4771,2015,0.9308079416414079,68953
29,"Guernsey County, Ohio",15558,3533,2015,0.8149389764810644,19091
30,"Hamilton County, Ohio",331638,45488,2015,0.8793824875505799,377126
31,"Hancock County, Ohio",31083,2187,2015,0.9342651036970243,33270
32,"Hardin County, Ohio",11540,1568,2015,0.8803783948733598,13108
33,"Harrison County, Ohio",6271,1844,2015,0.7727664818237832,8115
34,"Henry County, Ohio",10958,975,2015,0.9182938070895835,11933
35,"Highland County, Ohio",16696,2560,2015,0.8670544245949314,19256
36,"Hocking County, Ohio",11387,1964,2015,0.8528949142386338,13351
37,"Holmes County, Ohio",12685,922,2015,0.9322407584331595,13607
38,"Huron County, Ohio",22527,2607,2015,0.8962759608498448,25134
39,"Jackson County, Ohio",12981,1576,2015,0.8917359346019097,14557
40,"Jefferson County, Ohio",27958,4646,2015,0.8575021469758312,32604
41,"Knox County, Ohio",22759,2629,2015,0.8964471403812825,25388
42,"Lake County, Ohio",94815,6817,2015,0.932924669395466,101632
43,"Lawrence County, Ohio",23548,3870,2015,0.8588518491501933,27418
44,"Licking County, Ohio",64230,5549,2015,0.9204775075595809,69779
45,"Logan County, Ohio",18640,4523,2015,0.8047316841514485,23163
46,"Lorain County, Ohio",117298,10970,2015,0.9144759409985344,128268
47,"Lucas County, Ohio",177619,24650,2015,0.8781325858139408,202269
48,"Madison County, Ohio",14906,1007,2015,0.9367184063344436,15913
49,"Mahoning County, Ohio",97790,13675,2015,0.8773157493383573,111465
50,"Marion County, Ohio",24478,3351,2015,0.8795860433360883,27829
51,"Medina County, Ohio",66002,4237,2015,0.9396773872065377,70239
52,"Meigs County, Ohio",9322,1754,2015,0.8416395810762008,11076
53,"Mercer County, Ohio",15919,1726,2015,0.9021819212241429,17645
54,"Miami County, Ohio",41135,3131,2015,0.9292685130800162,44266
55,"Monroe County, Ohio",6056,1445,2015,0.8073590187974937,7501
56,"Montgomery County, Ohio",222687,31728,2015,0.8752903720299511,254415
57,"Morgan County, Ohio",6120,1729,2015,0.7797171614218372,7849
58,"Morrow County, Ohio",12700,1423,2015,0.8992423706011471,14123
59,"Muskingum County, Ohio",34261,3593,2015,0.9050826861097903,37854
60,"Noble County, Ohio",4886,1150,2015,0.8094764744864148,6036
61,"Ottawa County, Ohio",17334,10633,2015,0.6198019093932134,27967
62,"Paulding County, Ohio",7699,993,2015,0.8857570179475379,8692
63,"Perry County, Ohio",13780,1381,2015,0.9089110217004155,15161
64,"Pickaway County, Ohio",19460,1722,2015,0.9187045604758758,21182
65,"Pike County, Ohio",10940,1590,2015,0.8731045490822027,12530
66,"Portage County, Ohio",61055,6842,2015,0.8992297155986273,67897
67,"Preble County, Ohio",16124,1727,2015,0.9032547196235505,17851
68,"Putnam County, Ohio",13049,719,2015,0.9477774549680419,13768
69,"Richland County, Ohio",48103,6250,2015,0.8850109469578497,54353
70,"Ross County, Ohio",28269,3648,2015,0.8857035435661247,31917
71,"Sandusky County, Ohio",23626,2631,2015,0.8997981490650112,26257
72,"Scioto County, Ohio",29700,4384,2015,0.8713765989907288,34084
73,"Seneca County, Ohio",21538,2421,2015,0.8989523769773363,23959
74,"Shelby County, Ohio",18537,1664,2015,0.9176278402059304,20201
75,"Stark County, Ohio",150385,15077,2015,0.908879380159795,165462
76,"Summit County, Ohio",220902,24335,2015,0.9007694597471018,245237
77,"Trumbull County, Ohio",86828,8841,2015,0.9075876198141509,95669
78,"Tuscarawas County, Ohio",36713,3294,2015,0.9176644087284725,40007
79,"Union County, Ohio",18431,1384,2015,0.9301539237951048,19815
80,"Van Wert County, Ohio",11355,1317,2015,0.8960700757575758,12672
81,"Vinton County, Ohio",4992,1231,2015,0.8021854411055761,6223
82,"Warren County, Ohio",78359,4563,2015,0.9449723836858734,82922
83,"Washington County, Ohio",25064,3060,2015,0.891196131418006,28124
84,"Wayne County, Ohio",42910,3029,2015,0.9340647380221598,45939
85,"Williams County, Ohio",15150,1414,2015,0.9146341463414634,16564
86,"Wood County, Ohio",50091,3635,2015,0.9323418828872426,53726
87,"Wyandot County, Ohio",9327,567,2015,0.9426925409338993,9894
0,"Seneca County, Ohio",21539,2489,2014,0.8964125187281505,24028
1,"Shelby County, Ohio",18616,1594,2014,0.9211281543790203,20210
2,"Stark County, Ohio",149756,15522,2014,0.9060855044228512,165278
3,"Summit County, Ohio",220710,24468,2014,0.9002031177348702,245178
4,"Trumbull County, Ohio",86565,9234,2014,0.9036106848714496,95799
5,"Tuscarawas County, Ohio",36366,3696,2014,0.9077429983525536,40062
6,"Union County, Ohio",18291,1359,2014,0.9308396946564885,19650
7,"Van Wert County, Ohio",11388,1274,2014,0.8993839835728953,12662
8,"Vinton County, Ohio",5137,1103,2014,0.8232371794871794,6240
9,"Warren County, Ohio",77328,4824,2014,0.9412795793163892,82152
10,"Washington County, Ohio",24923,3274,2014,0.8838883569174025,28197
11,"Wayne County, Ohio",42593,3268,2014,0.9287411962233706,45861
12,"Williams County, Ohio",15001,1592,2014,0.9040559271982161,16593
13,"Wood County, Ohio",49561,4027,2014,0.9248525789355826,53588
14,"Wyandot County, Ohio",9327,563,2014,0.9430738119312437,9890
15,"Adams County, Ohio",10734,2149,2014,0.8331910269347201,12883
16,"Allen County, Ohio",40191,4739,2014,0.8945248163810372,44930
17,"Ashland County, Ohio",20339,1773,2014,0.9198172937771346,22112
18,"Ashtabula County, Ohio",38933,7031,2014,0.8470324601862327,45964
19,"Athens County, Ohio",22208,4107,2014,0.8439293178795364,26315
20,"Auglaize County, Ohio",18115,1486,2014,0.9241875414519667,19601
21,"Belmont County, Ohio",28007,4288,2014,0.8672240284873819,32295
22,"Brown County, Ohio",16587,2756,2014,0.857519516104017,19343
23,"Butler County, Ohio",134934,13852,2014,0.9068998427271383,148786
24,"Carroll County, Ohio",10922,2714,2014,0.8009680258140217,13636
25,"Champaign County, Ohio",15163,1550,2014,0.9072578232513612,16713
26,"Clark County, Ohio",54969,6277,2014,0.8975116742317866,61246
27,"Clermont County, Ohio",74187,7155,2014,0.912038061518035,81342
28,"Clinton County, Ohio",16052,2023,2014,0.8880774550484094,18075
29,"Columbiana County, Ohio",42184,4676,2014,0.9002134016218524,46860
30,"Coshocton County, Ohio",14561,1881,2014,0.8855978591412237,16442
31,"Crawford County, Ohio",17625,2457,2014,0.8776516283238721,20082
32,"Cuyahoga County, Ohio",534721,85142,2014,0.8626438422683722,619863
33,"Darke County, Ohio",20929,1765,2014,0.922226139067595,22694
34,"Defiance County, Ohio",15332,1410,2014,0.9157806713654283,16742
35,"Delaware County, Ohio",65029,2852,2014,0.9579852978005627,67881
36,"Erie County, Ohio",31998,5779,2014,0.847023321068375,37777
37,"Fairfield County, Ohio",54581,4526,2014,0.9234270052616441,59107
38,"Fayette County, Ohio",11532,1139,2014,0.9101096993133928,12671
39,"Franklin County, Ohio",474683,58669,2014,0.8899994750183744,533352
40,"Fulton County, Ohio",16333,1062,2014,0.9389479735556194,17395
41,"Gallia County, Ohio",11502,2347,2014,0.8305292800924254,13849
42,"Geauga County, Ohio",34753,1903,2014,0.9480848974247054,36656
43,"Greene County, Ohio",63549,5203,2014,0.9243222015359553,68752
44,"Guernsey County, Ohio",15564,3563,2014,0.8137188267893554,19127
45,"Hamilton County, Ohio",329062,47956,2014,0.8728018290903883,377018
46,"Hancock County, Ohio",30795,2426,2014,0.9269739020499081,33221
47,"Hardin County, Ohio",11438,1673,2014,0.8723972237052856,13111
48,"Harrison County, Ohio",6333,1797,2014,0.7789667896678967,8130
49,"Henry County, Ohio",11075,871,2014,0.9270885652101122,11946
50,"Highland County, Ohio",16837,2469,2014,0.8721122966953279,19306
51,"Hocking County, Ohio",11426,1941,2014,0.8547916510810204,13367
52,"Holmes County, Ohio",12516,1116,2014,0.9181338028169014,13632
53,"Huron County, Ohio",22507,2643,2014,0.8949105367793241,25150
54,"Jackson County, Ohio",13204,1370,2014,0.9059969809249349,14574
55,"Jefferson County, Ohio",28176,4485,2014,0.862680260861578,32661
56,"Knox County, Ohio",22642,2691,2014,0.8937749180910275,25333
57,"Lake County, Ohio",94089,7379,2014,0.9272775653407971,101468
58,"Lawrence County, Ohio",23622,3852,2014,0.8597947150032759,27474
59,"Licking County, Ohio",64146,5475,2014,0.9213599345025207,69621
60,"Logan County, Ohio",18471,4681,2014,0.7978144436765722,23152
61,"Lorain County, Ohio",117134,10767,2014,0.9158177027544742,127901
62,"Lucas County, Ohio",178121,24202,2014,0.8803793933462829,202323
63,"Madison County, Ohio",14676,1228,2014,0.9227867203219315,15904
64,"Mahoning County, Ohio",97624,13940,2014,0.8750492990570435,111564
65,"Marion County, Ohio",24586,3211,2014,0.8844839371155161,27797
66,"Medina County, Ohio",65950,3969,2014,0.9432343139919049,69919
67,"Meigs County, Ohio",9486,1615,2014,0.8545176110260337,11101
68,"Mercer County, Ohio",15923,1732,2014,0.9018974794675729,17655
69,"Miami County, Ohio",41169,3105,2014,0.9298685458734246,44274
70,"Monroe County, Ohio",6056,1469,2014,0.8047840531561462,7525
71,"Montgomery County, Ohio",222673,31793,2014,0.8750599294208263,254466
72,"Morgan County, Ohio",6056,1802,2014,0.770679562229575,7858
73,"Morrow County, Ohio",12640,1477,2014,0.8953743713253524,14117
74,"Muskingum County, Ohio",34160,3746,2014,0.9011765947343429,37906
75,"Noble County, Ohio",4916,1121,2014,0.8143117442438297,6037
76,"Ottawa County, Ohio",17366,10584,2014,0.6213237924865832,27950
77,"Paulding County, Ohio",7798,920,2014,0.8944712089928882,8718
78,"Perry County, Ohio",13637,1525,2014,0.8994196016356681,15162
79,"Pickaway County, Ohio",19435,1790,2014,0.9156654888103651,21225
80,"Pike County, Ohio",10944,1590,2014,0.8731450454763044,12534
81,"Portage County, Ohio",61042,6773,2014,0.9001253410012534,67815
82,"Preble County, Ohio",16151,1719,2014,0.9038052602126468,17870
83,"Putnam County, Ohio",13006,756,2014,0.9450661241098678,13762
84,"Richland County, Ohio",48211,6210,2014,0.8858896381911394,54421
85,"Ross County, Ohio",28209,3724,2014,0.883380828609902,31933
86,"Sandusky County, Ohio",23831,2462,2014,0.9063629102803027,26293
87,"Scioto County, Ohio",29558,4542,2014,0.8668035190615836,34100
0,"Fayette County, Ohio",11514,1147,2013,0.9094068399020615,12661
1,"Franklin County, Ohio",468295,61629,2013,0.8837021912576143,529924
2,"Fulton County, Ohio",16285,1085,2013,0.9375359815774323,17370
3,"Gallia County, Ohio",11576,2251,2013,0.8372025746727417,13827
4,"Geauga County, Ohio",34621,1931,2013,0.9471711534252572,36552
5,"Greene County, Ohio",62836,5641,2013,0.9176219752617667,68477
6,"Guernsey County, Ohio",15690,3401,2013,0.8218532292703368,19091
7,"Hamilton County, Ohio",327914,49013,2013,0.869966863610195,376927
8,"Hancock County, Ohio",30610,2548,2013,0.9231557995053984,33158
9,"Hardin County, Ohio",11504,1583,2013,0.8790402689692061,13087
10,"Harrison County, Ohio",6395,1714,2013,0.7886299173757554,8109
11,"Henry County, Ohio",11006,912,2013,0.9234770934720591,11918
12,"Highland County, Ohio",16918,2361,2013,0.8775351418642046,19279
13,"Hocking County, Ohio",11478,1871,2013,0.8598396883661698,13349
14,"Holmes County, Ohio",12467,1143,2013,0.916017634092579,13610
15,"Huron County, Ohio",22361,2766,2013,0.8899192104111115,25127
16,"Jackson County, Ohio",13288,1258,2013,0.9135157431596315,14546
17,"Jefferson County, Ohio",28326,4363,2013,0.8665300253908043,32689
18,"Knox County, Ohio",22583,2601,2013,0.8967201397712834,25184
19,"Lake County, Ohio",94048,7170,2013,0.9291627971309451,101218
20,"Lawrence County, Ohio",24009,3477,2013,0.873499235974678,27486
21,"Licking County, Ohio",64009,5400,2013,0.922200291028541,69409
22,"Logan County, Ohio",18143,4976,2013,0.7847657770664821,23119
23,"Lorain County, Ohio",116705,10577,2013,0.9169010543517544,127282
24,"Lucas County, Ohio",178101,24095,2013,0.8808334487329126,202196
25,"Madison County, Ohio",14611,1286,2013,0.9191042335031767,15897
26,"Mahoning County, Ohio",98201,13328,2013,0.8804974490939577,111529
27,"Marion County, Ohio",24578,3191,2013,0.8850876877093161,27769
28,"Medina County, Ohio",65499,3995,2013,0.9425130227069963,69494
29,"Meigs County, Ohio",9560,1533,2013,0.8618047417290183,11093
30,"Mercer County, Ohio",15851,1744,2013,0.9008809320829781,17595
31,"Miami County, Ohio",41239,2946,2013,0.9333257892950096,44185
32,"Monroe County, Ohio",6111,1412,2013,0.8123089193141034,7523
33,"Montgomery County, Ohio",222578,31783,2013,0.8750476684711885,254361
34,"Morgan County, Ohio",6204,1658,2013,0.789112185194607,7862
35,"Morrow County, Ohio",12940,1140,2013,0.9190340909090909,14080
36,"Muskingum County, Ohio",33976,3901,2013,0.8970087388124719,37877
37,"Noble County, Ohio",4883,1147,2013,0.8097844112769486,6030
38,"Ottawa County, Ohio",17614,10262,2013,0.6318697087100015,27876
39,"Paulding County, Ohio",7730,983,2013,0.887180075748881,8713
40,"Perry County, Ohio",13793,1336,2013,0.91169277546434,15129
41,"Pickaway County, Ohio",19167,2011,2013,0.9050429691188969,21178
42,"Pike County, Ohio",10859,1604,2013,0.8712990451737141,12463
43,"Portage County, Ohio",60992,6495,2013,0.9037592425207818,67487
44,"Preble County, Ohio",16238,1585,2013,0.911069965774561,17823
45,"Putnam County, Ohio",13022,700,2013,0.9489870281300102,13722
46,"Richland County, Ohio",48458,5986,2013,0.8900521636911322,54444
47,"Ross County, Ohio",28308,3619,2013,0.8866476649857488,31927
48,"Sandusky County, Ohio",23906,2399,2013,0.9088006082493822,26305
49,"Scioto County, Ohio",29452,4586,2013,0.8652682296257125,34038
50,"Seneca County, Ohio",21651,2384,2013,0.9008113168296235,24035
51,"Shelby County, Ohio",18311,1878,2013,0.9069790479964337,20189
52,"Stark County, Ohio",150003,15033,2013,0.9089107831018687,165036
53,"Summit County, Ohio",220375,24535,2013,0.8998203421665102,244910
54,"Trumbull County, Ohio",86246,9600,2013,0.8998393255847923,95846
55,"Tuscarawas County, Ohio",36149,3894,2013,0.902754538870714,40043
56,"Union County, Ohio",18216,1298,2013,0.9334836527621195,19514
57,"Van Wert County, Ohio",11442,1182,2013,0.9063688212927756,12624
58,"Vinton County, Ohio",5191,1035,2013,0.8337616447157083,6226
59,"Warren County, Ohio",76546,4824,2013,0.9407152513211258,81370
60,"Washington County, Ohio",25029,3188,2013,0.8870184640464968,28217
61,"Wayne County, Ohio",42487,3294,2013,0.9280487538498504,45781
62,"Williams County, Ohio",14947,1658,2013,0.9001505570611261,16605
63,"Wood County, Ohio",49086,4333,2013,0.9188865384975383,53419
64,"Wyandot County, Ohio",9284,575,2013,0.9416776549345776,9859
65,"Adams County, Ohio",10816,2051,2013,0.8405999844563612,12867
66,"Allen County, Ohio",40552,4350,2013,0.9031223553516547,44902
67,"Ashland County, Ohio",20207,1871,2013,0.9152550049823354,22078
68,"Ashtabula County, Ohio",38952,7006,2013,0.8475564645981113,45958
69,"Athens County, Ohio",22181,4098,2013,0.844057993074318,26279
70,"Auglaize County, Ohio",18241,1337,2013,0.931709061191133,19578
71,"Belmont County, Ohio",28329,3998,2013,0.8763262907167383,32327
72,"Brown County, Ohio",16380,2881,2013,0.850423134832044,19261
73,"Butler County, Ohio",134612,13691,2013,0.9076822451332744,148303
74,"Carroll County, Ohio",11107,2521,2013,0.8150132081009686,13628
75,"Champaign County, Ohio",15014,1693,2013,0.8986652301430538,16707
76,"Clark County, Ohio",54963,6304,2013,0.8971061093247589,61267
77,"Clermont County, Ohio",73728,7189,2013,0.9111558757739412,80917
78,"Clinton County, Ohio",15969,2119,2013,0.8828505086245024,18088
79,"Columbiana County, Ohio",42095,4787,2013,0.8978925813745148,46882
80,"Coshocton County, Ohio",14495,1931,2013,0.8824424692560575,16426
81,"Crawford County, Ohio",17655,2436,2013,0.8787516798566523,20091
82,"Cuyahoga County, Ohio",534476,85552,2013,0.8620191346197269,620028
83,"Darke County, Ohio",20776,1913,2013,0.9156860152496804,22689
84,"Defiance County, Ohio",15203,1500,2013,0.9101957732143926,16703
85,"Delaware County, Ohio",64208,2807,2013,0.9581138551070656,67015
86,"Erie County, Ohio",31972,5795,2013,0.8465591654089549,37767
87,"Fairfield County, Ohio",54309,4482,2013,0.9237638414042966,58791
0,"Adams County, Ohio",10923,1990,2012,0.8458917370092155,12913
1,"Allen County, Ohio",40622,4373,2012,0.902811423491499,44995
2,"Ashland County, Ohio",20266,1862,2012,0.9158532176428055,22128
3,"Ashtabula County, Ohio",38889,7166,2012,0.8444034306807079,46055
4,"Athens County, Ohio",22221,4078,2012,0.8449370698505647,26299
5,"Auglaize County, Ohio",18342,1223,2012,0.937490416560184,19565
6,"Belmont County, Ohio",28716,3692,2012,0.8860775117254999,32408
7,"Brown County, Ohio",16289,2984,2012,0.8451720022829866,19273
8,"Butler County, Ohio",134945,13061,2012,0.9117535775576666,148006
9,"Carroll County, Ohio",11424,2240,2012,0.8360655737704918,13664
10,"Champaign County, Ohio",15240,1508,2012,0.909959398137091,16748
11,"Clark County, Ohio",54959,6495,2012,0.8943111921111726,61454
12,"Clermont County, Ohio",73859,6802,2012,0.9156717620659303,80661
13,"Clinton County, Ohio",16018,2112,2012,0.883507997793712,18130
14,"Columbiana County, Ohio",42476,4549,2012,0.903264221158958,47025
15,"Coshocton County, Ohio",14516,1977,2012,0.8801309646516704,16493
16,"Crawford County, Ohio",17664,2480,2012,0.8768864177918984,20144
17,"Cuyahoga County, Ohio",534899,86285,2012,0.8610959071708222,621184
18,"Darke County, Ohio",20856,1832,2012,0.9192524682651622,22688
19,"Defiance County, Ohio",15302,1432,2012,0.914425720090833,16734
20,"Delaware County, Ohio",63376,2918,2012,0.9559839502820768,66294
21,"Erie County, Ohio",31712,6126,2012,0.838099265288863,37838
22,"Fairfield County, Ohio",54302,4269,2012,0.9271141008348841,58571
23,"Fayette County, Ohio",11474,1205,2012,0.9049609590661725,12679
24,"Franklin County, Ohio",464018,63868,2012,0.8790117563261765,527886
25,"Fulton County, Ohio",16358,1012,2012,0.9417386298215313,17370
26,"Gallia County, Ohio",11885,2007,2012,0.8555283616469911,13892
27,"Geauga County, Ohio",34624,1873,2012,0.9486807134833,36497
28,"Greene County, Ohio",62681,5556,2012,0.918577897621525,68237
29,"Guernsey County, Ohio",15808,3377,2012,0.8239770654156894,19185
30,"Hamilton County, Ohio",326023,51601,2012,0.863353494481283,377624
31,"Hancock County, Ohio",30342,2829,2012,0.9147146603961291,33171
32,"Hardin County, Ohio",11822,1309,2012,0.9003122382149112,13131
33,"Harrison County, Ohio",6324,1830,2012,0.775570272259014,8154
34,"Henry County, Ohio",11151,812,2012,0.9321240491515506,11963
35,"Highland County, Ohio",16969,2339,2012,0.8788585042469442,19308
36,"Hocking County, Ohio",11562,1810,2012,0.8646425366437331,13372
37,"Holmes County, Ohio",12183,1429,2012,0.8950191007934176,13612
38,"Huron County, Ohio",22673,2493,2012,0.9009377731860446,25166
39,"Jackson County, Ohio",13411,1161,2012,0.9203266538567115,14572
40,"Jefferson County, Ohio",28608,4199,2012,0.8720090224647179,32807
41,"Knox County, Ohio",22483,2630,2012,0.8952733643929439,25113
42,"Lake County, Ohio",94389,6647,2012,0.9342115681539254,101036
43,"Lawrence County, Ohio",23990,3606,2012,0.8693288882446731,27596
44,"Licking County, Ohio",63781,5427,2012,0.9215842099179286,69208
45,"Logan County, Ohio",18050,5124,2012,0.7788901354966773,23174
46,"Lorain County, Ohio",116391,10535,2012,0.9169988812378866,126926
47,"Lucas County, Ohio",178615,24008,2012,0.8815139446163565,202623
48,"Madison County, Ohio",14779,1124,2012,0.9293215116644659,15903
49,"Mahoning County, Ohio",98460,13409,2012,0.8801365883309943,111869
50,"Marion County, Ohio",24736,3107,2012,0.8884100132887979,27843
51,"Medina County, Ohio",65272,3833,2012,0.9445336806309239,69105
52,"Meigs County, Ohio",9598,1563,2012,0.8599587850551026,11161
53,"Mercer County, Ohio",15715,1836,2012,0.8953905760355535,17551
54,"Miami County, Ohio",41225,2901,2012,0.9342564474459503,44126
55,"Monroe County, Ohio",6071,1481,2012,0.8038930084745762,7552
56,"Montgomery County, Ohio",222892,31745,2012,0.8753323358349336,254637
57,"Morgan County, Ohio",6271,1615,2012,0.7952066954095867,7886
58,"Morrow County, Ohio",13035,1080,2012,0.9234856535600425,14115
59,"Muskingum County, Ohio",33986,3901,2012,0.8970359226119777,37887
60,"Noble County, Ohio",4804,1216,2012,0.7980066445182724,6020
61,"Ottawa County, Ohio",17688,10199,2012,0.6342740344963603,27887
62,"Paulding County, Ohio",7700,1055,2012,0.8794974300399772,8755
63,"Perry County, Ohio",13688,1463,2012,0.9034387169163751,15151
64,"Pickaway County, Ohio",19196,1985,2012,0.9062839337141778,21181
65,"Pike County, Ohio",10730,1745,2012,0.8601202404809619,12475
66,"Portage County, Ohio",61016,6406,2012,0.904986502921895,67422
67,"Preble County, Ohio",16396,1473,2012,0.9175667356875035,17869
68,"Putnam County, Ohio",13083,651,2012,0.9525993883792049,13734
69,"Richland County, Ohio",48636,5927,2012,0.8913732749298976,54563
70,"Ross County, Ohio",27966,4036,2012,0.873882882319855,32002
71,"Sandusky County, Ohio",23905,2459,2012,0.9067288727052041,26364
72,"Scioto County, Ohio",29570,4617,2012,0.8649486646971071,34187
73,"Seneca County, Ohio",21891,2200,2012,0.9086795898883401,24091
74,"Shelby County, Ohio",18287,1883,2012,0.9066435299950422,20170
75,"Stark County, Ohio",150299,14827,2012,0.9102079624044669,165126
76,"Summit County, Ohio",221296,23633,2012,0.9035108133377427,244929
77,"Trumbull County, Ohio",86760,9393,2012,0.902311940345075,96153
78,"Tuscarawas County, Ohio",36298,3825,2012,0.9046681454527329,40123
79,"Union County, Ohio",18113,1319,2012,0.93212227254014,19432
80,"Van Wert County, Ohio",11296,1331,2012,0.8945909558881762,12627
81,"Vinton County, Ohio",5313,945,2012,0.8489932885906041,6258
82,"Warren County, Ohio",75875,4851,2012,0.9399078363848079,80726
83,"Washington County, Ohio",24975,3348,2012,0.8817921830314586,28323
84,"Wayne County, Ohio",42354,3472,2012,0.924235150351329,45826
85,"Williams County, Ohio",15033,1635,2012,0.9019078473722102,16668
86,"Wood County, Ohio",48789,4577,2012,0.9142337818086422,53366
87,"Wyandot County, Ohio",9281,587,2012,0.9405147952979327,9868
0,"Licking County, Ohio",63314,5655,2011,0.9180066406646464,68969
1,"Logan County, Ohio",18095,5067,2011,0.7812365080735688,23162
2,"Lorain County, Ohio",115534,10912,2011,0.913702291887446,126446
3,"Lucas County, Ohio",178777,23901,2011,0.882074028754971,202678
4,"Madison County, Ohio",14791,1105,2011,0.9304856567689985,15896
5,"Mahoning County, Ohio",98749,13325,2011,0.8811053411139069,112074
6,"Marion County, Ohio",24851,2972,2011,0.8931818998670165,27823
7,"Medina County, Ohio",64813,3842,2011,0.9440390357585027,68655
8,"Meigs County, Ohio",9644,1549,2011,0.8616099347806665,11193
9,"Mercer County, Ohio",15689,1881,2011,0.892942515651679,17570
10,"Miami County, Ohio",41364,2687,2011,0.9390025198065878,44051
11,"Monroe County, Ohio",6167,1400,2011,0.8149861239592969,7567
12,"Montgomery County, Ohio",223546,31275,2011,0.8772667872742043,254821
13,"Morgan County, Ohio",6252,1649,2011,0.7912922414884191,7901
14,"Morrow County, Ohio",13084,967,2011,0.931179275496406,14051
15,"Muskingum County, Ohio",34262,3637,2011,0.9040344072402966,37899
16,"Noble County, Ohio",4771,1252,2011,0.7921301676905197,6023
17,"Ottawa County, Ohio",18009,9798,2011,0.6476426799007444,27807
18,"Paulding County, Ohio",7571,1199,2011,0.8632839224629418,8770
19,"Perry County, Ohio",13762,1381,2011,0.9088027471438949,15143
20,"Pickaway County, Ohio",19284,1857,2011,0.9121612033489428,21141
21,"Pike County, Ohio",10816,1616,2011,0.87001287001287,12432
22,"Portage County, Ohio",61746,5481,2011,0.9184702574858316,67227
23,"Preble County, Ohio",16321,1563,2011,0.912603444419593,17884
24,"Putnam County, Ohio",12936,751,2011,0.9451304157229488,13687
25,"Richland County, Ohio",48593,6094,2011,0.888565838316236,54687
26,"Ross County, Ohio",28158,3869,2011,0.8791956786461423,32027
27,"Sandusky County, Ohio",24031,2362,2011,0.9105065737127268,26393
28,"Scioto County, Ohio",29788,4432,2011,0.8704850964348334,34220
29,"Seneca County, Ohio",22026,2123,2011,0.9120874570375584,24149
30,"Shelby County, Ohio",18507,1622,2011,0.919419742659844,20129
31,"Stark County, Ohio",150072,15009,2011,0.9090809966016683,165081
32,"Summit County, Ohio",221498,23319,2011,0.9047492616934282,244817
33,"Trumbull County, Ohio",86746,9516,2011,0.9011447923375787,96262
34,"Tuscarawas County, Ohio",36262,3877,2011,0.9034106479982063,40139
35,"Union County, Ohio",17795,1508,2011,0.9218774283790084,19303
36,"Van Wert County, Ohio",11381,1241,2011,0.9016796070353351,12622
37,"Vinton County, Ohio",5305,949,2011,0.8482571154461145,6254
38,"Warren County, Ohio",75283,4732,2011,0.9408610885458977,80015
39,"Washington County, Ohio",25184,3199,2011,0.88729168868689,28383
40,"Wayne County, Ohio",42485,3319,2011,0.9275390795563706,45804
41,"Williams County, Ohio",15139,1557,2011,0.9067441303306181,16696
42,"Wood County, Ohio",48680,4506,2011,0.9152784567367352,53186
43,"Wyandot County, Ohio",9179,680,2011,0.9310274875748048,9859
44,"Adams County, Ohio",10905,2022,2011,0.8435831979577628,12927
45,"Allen County, Ohio",40703,4345,2011,0.9035473272953294,45048
46,"Ashland County, Ohio",20125,1991,2011,0.9099746789654549,22116
47,"Ashtabula County, Ohio",38771,7293,2011,0.8416767974991316,46064
48,"Athens County, Ohio",22496,3763,2011,0.8566967515899311,26259
49,"Auglaize County, Ohio",18297,1248,2011,0.9361473522640061,19545
50,"Belmont County, Ohio",28747,3656,2011,0.8871709409622566,32403
51,"Brown County, Ohio",16112,3046,2011,0.8410063680968786,19158
52,"Butler County, Ohio",135104,12654,2011,0.9143599669730235,147758
53,"Carroll County, Ohio",11485,2180,2011,0.840468349798756,13665
54,"Champaign County, Ohio",15278,1475,2011,0.9119560675699875,16753
55,"Clark County, Ohio",54771,6691,2011,0.8911359864631805,61462
56,"Clermont County, Ohio",73333,6983,2011,0.9130559290801334,80316
57,"Clinton County, Ohio",16190,1937,2011,0.893142825619242,18127
58,"Columbiana County, Ohio",42235,4910,2011,0.8958532187930852,47145
59,"Coshocton County, Ohio",14375,2175,2011,0.8685800604229608,16550
60,"Crawford County, Ohio",17905,2273,2011,0.8873525621964515,20178
61,"Cuyahoga County, Ohio",537203,85004,2011,0.8633830863362193,622207
62,"Darke County, Ohio",20700,1988,2011,0.91237658674189,22688
63,"Defiance County, Ohio",15183,1550,2011,0.9073686726827228,16733
64,"Delaware County, Ohio",62618,2876,2011,0.956087580541729,65494
65,"Erie County, Ohio",31642,6206,2011,0.8360283238216022,37848
66,"Fairfield County, Ohio",54388,3995,2011,0.9315725468030077,58383
67,"Fayette County, Ohio",11543,1149,2011,0.9094705326189726,12692
68,"Franklin County, Ohio",460497,65295,2011,0.875815911995618,525792
69,"Fulton County, Ohio",16332,1039,2011,0.9401876691036786,17371
70,"Gallia County, Ohio",12009,1914,2011,0.8625296272355096,13923
71,"Geauga County, Ohio",34447,2007,2011,0.9449443133812476,36454
72,"Greene County, Ohio",62558,5286,2011,0.922085961912623,67844
73,"Guernsey County, Ohio",15913,3306,2011,0.8279827254279619,19219
74,"Hamilton County, Ohio",325766,52349,2011,0.861552702220224,378115
75,"Hancock County, Ohio",30425,2585,2011,0.9216903968494395,33010
76,"Hardin County, Ohio",11692,1434,2011,0.8907511808624105,13126
77,"Harrison County, Ohio",6298,1843,2011,0.7736150350079842,8141
78,"Henry County, Ohio",11110,845,2011,0.9293182768716018,11955
79,"Highland County, Ohio",16841,2446,2011,0.8731788251153627,19287
80,"Hocking County, Ohio",11491,1866,2011,0.8602979711012952,13357
81,"Holmes County, Ohio",12261,1347,2011,0.9010141093474426,13608
82,"Huron County, Ohio",22684,2468,2011,0.9018765903307888,25152
83,"Jackson County, Ohio",13252,1317,2011,0.909602580822294,14569
84,"Jefferson County, Ohio",28741,4151,2011,0.8737991000851271,32892
85,"Knox County, Ohio",22495,2502,2011,0.8999079889586751,24997
86,"Lake County, Ohio",94347,6475,2011,0.9357779056158378,100822
87,"Lawrence County, Ohio",24479,3165,2011,0.8855086094631747,27644
0,"Adams County, Ohio",10754,2113,2010,0.8357814564389524,12867
1,"Allen County, Ohio",40719,4370,2010,0.9030805739759143,45089
2,"Ashland County, Ohio",20040,2060,2010,0.9067873303167421,22100
3,"Ashtabula County, Ohio",38911,7143,2010,0.8448994658444435,46054
4,"Athens County, Ohio",22283,3833,2010,0.8532317353346608,26116
5,"Auglaize County, Ohio",18209,1301,2010,0.9333162480779088,19510
6,"Belmont County, Ohio",29004,3366,2010,0.8960148285449491,32370
7,"Brown County, Ohio",15997,2958,2010,0.8439461883408071,18955
8,"Butler County, Ohio",134287,12517,2010,0.9147366556769571,146804
9,"Carroll County, Ohio",11488,2135,2010,0.8432797474858695,13623
10,"Champaign County, Ohio",15161,1604,2010,0.9043244855353415,16765
11,"Clark County, Ohio",55145,6429,2010,0.8955890473251698,61574
12,"Clermont County, Ohio",72927,6872,2010,0.9138836326269753,79799
13,"Clinton County, Ohio",16323,1767,2010,0.9023217247097844,18090
14,"Columbiana County, Ohio",42162,5022,2010,0.8935656154628687,47184
15,"Coshocton County, Ohio",14582,1988,2010,0.88002414001207,16570
16,"Crawford County, Ohio",18105,2145,2010,0.894074074074074,20250
17,"Cuyahoga County, Ohio",538944,83693,2010,0.8655829961920027,622637
18,"Darke County, Ohio",20769,1885,2010,0.9167917365586651,22654
19,"Defiance County, Ohio",15232,1508,2010,0.9099163679808842,16740
20,"Delaware County, Ohio",61203,3134,2010,0.9512877504390942,64337
21,"Erie County, Ohio",31855,5953,2010,0.8425465509944985,37808
22,"Fairfield County, Ohio",53911,3965,2010,0.9314914645103325,57876
23,"Fayette County, Ohio",11597,1059,2010,0.9163242730720607,12656
24,"Franklin County, Ohio",457799,65782,2010,0.8743613691100326,523581
25,"Fulton County, Ohio",16345,1010,2010,0.9418035148372227,17355
26,"Gallia County, Ohio",12246,1640,2010,0.881895434250324,13886
27,"Geauga County, Ohio",34285,1980,2010,0.9454019026609679,36265
28,"Greene County, Ohio",61962,5417,2010,0.9196040309295181,67379
29,"Guernsey County, Ohio",16217,3074,2010,0.8406510808148878,19291
30,"Hamilton County, Ohio",327864,51050,2010,0.865272858748951,378914
31,"Hancock County, Ohio",30632,2209,2010,0.9327365183764197,32841
32,"Hardin County, Ohio",11768,1368,2010,0.8958587088915956,13136
33,"Harrison County, Ohio",6377,1760,2010,0.7837040678382696,8137
34,"Henry County, Ohio",11111,877,2010,0.9268435101768435,11988
35,"Highland County, Ohio",16638,2528,2010,0.8680997599916519,19166
36,"Hocking County, Ohio",11486,1786,2010,0.8654309825195902,13272
37,"Holmes County, Ohio",12120,1398,2010,0.8965823346648912,13518
38,"Huron County, Ohio",22972,2082,2010,0.9168994970862936,25054
39,"Jackson County, Ohio",13105,1483,2010,0.8983411022758432,14588
40,"Jefferson County, Ohio",29130,3895,2010,0.8820590461771385,33025
41,"Knox County, Ohio",22582,2237,2010,0.909867440267537,24819
42,"Lake County, Ohio",94211,6135,2010,0.9388615390748012,100346
43,"Lawrence County, Ohio",24631,3056,2010,0.8896232889081518,27687
44,"Licking County, Ohio",62569,5829,2010,0.914778209889178,68398
45,"Logan County, Ohio",18398,4732,2010,0.7954172070903588,23130
46,"Lorain County, Ohio",114479,11067,2010,0.9118490433785226,125546
47,"Lucas County, Ohio",179000,23659,2010,0.8832570968967576,202659
48,"Madison County, Ohio",14745,1100,2010,0.9305774692331966,15845
49,"Mahoning County, Ohio",99024,13293,2010,0.8816474799006384,112317
50,"Marion County, Ohio",24863,2839,2010,0.8975164248068731,27702
51,"Medina County, Ohio",64202,3604,2010,0.946848361501932,67806
52,"Meigs County, Ohio",9675,1506,2010,0.8653072176012879,11181
53,"Mercer County, Ohio",15606,1826,2010,0.8952501147315283,17432
54,"Miami County, Ohio",41087,2729,2010,0.9377168157750594,43816
55,"Monroe County, Ohio",6174,1376,2010,0.817748344370861,7550
56,"Montgomery County, Ohio",223660,31165,2010,0.8777003826155204,254825
57,"Morgan County, Ohio",6187,1713,2010,0.7831645569620254,7900
58,"Morrow County, Ohio",13037,892,2010,0.9359609447914423,13929
59,"Muskingum County, Ohio",34121,3523,2010,0.9064127085325683,37644
60,"Noble County, Ohio",4904,1078,2010,0.8197927114677366,5982
61,"Ottawa County, Ohio",17933,9723,2010,0.6484307202776974,27656
62,"Paulding County, Ohio",7661,1127,2010,0.8717569412835685,8788
63,"Perry County, Ohio",13554,1487,2010,0.9011368924938501,15041
64,"Pickaway County, Ohio",19045,1920,2010,0.9084187932268066,20965
65,"Pike County, Ohio",10643,1779,2010,0.8567863468040573,12422
66,"Portage County, Ohio",61819,5041,2010,0.9246036494166916,66860
67,"Preble County, Ohio",16392,1502,2010,0.9160612495808651,17894
68,"Putnam County, Ohio",12891,772,2010,0.94349703579009,13663
69,"Richland County, Ohio",48557,6200,2010,0.8867724674470844,54757
70,"Ross County, Ohio",28107,3768,2010,0.8817882352941177,31875
71,"Sandusky County, Ohio",24109,2276,2010,0.9137388667803676,26385
72,"Scioto County, Ohio",30162,4188,2010,0.8780786026200873,34350
73,"Seneca County, Ohio",22138,2078,2010,0.9141889659729104,24216
74,"Shelby County, Ohio",18488,1561,2010,0.9221407551498828,20049
75,"Stark County, Ohio",150921,13903,2010,0.9156494199873805,164824
76,"Summit County, Ohio",223122,21192,2010,0.9132591664824775,244314
77,"Trumbull County, Ohio",86463,9900,2010,0.8972634724946297,96363
78,"Tuscarawas County, Ohio",36128,3914,2010,0.9022526347335298,40042
79,"Union County, Ohio",17826,1303,2010,0.9318835276282085,19129
80,"Van Wert County, Ohio",11472,1179,2010,0.9068057861038653,12651
81,"Vinton County, Ohio",5349,869,2010,0.8602444515921518,6218
82,"Warren County, Ohio",74144,4735,2010,0.9399713485211526,78879
83,"Washington County, Ohio",25373,3034,2010,0.8931953391769635,28407
84,"Wayne County, Ohio",42395,3301,2010,0.9277617296918768,45696
85,"Williams County, Ohio",14953,1767,2010,0.8943181818181818,16720
86,"Wood County, Ohio",48636,4279,2010,0.9191344609279033,52915
87,"Wyandot County, Ohio",9169,687,2010,0.9302962662337663,9856
